0000000000
0004444400
0444000400
0419200400
0444021400
0414420400
0404010440
0420222140
0400010040
0444444440
0000000000