100000000
010000000
001000000
000100000
000010000
000001000
000000100
000000010
000000001
000000010
000000100